111111211111111
110001010010001
110100010111101
100111110101101
110000110101001
110101100000011
111101111111011
100000100000001
101111101101111
101111101101101
100000000100001
101101111101011
111101100001001
100000001101111
111111111111111